Personality and Social Psychology Bulletin	Pers Soc Psychol Bull
Personality & Social Psychology Bulletin	Pers Soc Psychol Bull
Personality & social psychology bulletin	Pers Soc Psychol Bull
The Review of Economic Studies	Rev Econ Stud
Review of Economic Studies	Rev Econ Stud
Econometrica : Journal of the Econometric Society	Econometrica
Econometrica	Econometrica
Multivariate Behavioral Research	Multivariate Behav Res
Journal of petroleum technology	J Pet Tech
"Philosophical Transactions of the Royal Society of London. Series B, Biological Sciences"	Philos Trans R Soc Lond B Biol Sci
Philosophical Transactions of the Royal Society B: Biological Sciences	Philos Trans R Soc Lond B Biol Sci
Evolution and Human Behavior	Evo Hum Behav
Psychonomic Bulletin & Review	Psychon Bull Rev
Physiology & Behavior	Physiol Behav
Psychonomic bulletin & review	Psychon Bull Rev
The Journal of Social Issues	J Soc Issues
Journal of Social Issues	J Soc Issues
Behavioral and Brain Sciences	Behav Brain Sci
Addictive behaviors	Addict Behav
Administrative Science Quarterly	Adm Sci Q
The American psychologist	Am Psychol
Annals of the New York Academy of Sciences	Ann N Y Acad Sci
Annual review of neuroscience	Annu Rev Neurosci
Annual Review of Psychology	Annu Rev Psychol
Annual review of psychology	Annu Rev Psychol
Archives of neurology	Arch Neurol
Archives of sexual behavior	Arch Sex Behav
The Biochemical journal	Biochem J
BioEssays : news and reviews in molecular, cellular and developmental biology	Bioessays
Biological cybernetics	Biol Cybern
Biological Psychiatry	Biol Psychiatry
Biological psychiatry	Biol Psychiatry
Biological Psychology	Biol Psychol
NeuroReport	Neuroreport
Neuropsychopharmacology : official publication of the American College of Neuropsychopharmacology	Neuropsychopharmacology
Behavioural brain research	Behav Brain Res
Behavioral Neuroscience	Behav Neurosci
Brain and cognition	Brain Cogn
Neuron	Neuron
American journal of preventive medicine	Am J Prev Med
The American Economic Review	Am Econ Rev
British Medical Journal	Br Med J
Brain : a journal of neurology	Brain
Brain Research	Brain Res
Brain research	Brain Res
Business Horizons	Bus Horiz
Molecular Biology of the Cell	Mol Biol Cell
Molecular biology of the cell	Mol Biol Cell
Brain, Behavior, and Immunity	Brain Behav Immun
Cerebral cortex (New York, N.Y. : 1991)	Cereb Cortex
Current Opinion in Neurobiology	Curr Opin Neurobiol
Current opinion in neurobiology	Curr Opin Neurobiol
BMJ (Clinical research ed.)	Bmj
Journal of physiology, Paris	J Physiol Paris
Nature genetics	Nat Genet
Hippocampus	Hippocampus
Cell	Cell
Child development	Child Dev
Clinical Endocrinology	Clin Endocrinol (Oxf)
Cognitive psychology	Cogn Psychol
Cognition	Cognition
Computer Methods and Programs in Biomedicine	Comput Methods Programs Biomed
Culture, medicine and psychiatry	Cult Med Psychiatry
BioScience	Bioscience
Frontiers in neuroendocrinology	Front Neuroendocrinol
Developmental psychobiology	Dev Psychobiol
Daedalus	Daedalus
Economic Inquiry	Econ Inq
Hormones and Behavior	Horm Behav
Hormones and behavior	Horm Behav
Hormones	Hormones
Infection and Immunity	Infect Immun
Infection and immunity	Infect Immun
Infection	Infection
Journal of Abnormal Child Psychology	J Abnorm Child Psychol
Journal of Abnormal Psychology	J Abnorm Psychol
Journal of abnormal psychology	J Abnorm Psychol
Journal of Applied Behavior Analysis	J Appl Behav Anal
Journal of the American Academy of Child and Adolescent Psychiatry	J Am Acad Child Adolesc Psychiatry
Journal of child psychology and psychiatry, and allied disciplines	J Child Psychol Psychiatry
Journal of the Experimental Analysis of Behavior	J Exp Anal Behav
Journal of the experimental analysis of behavior	J Exp Anal Behav
Journal of experimental child psychology	J Exp Child Psychol
The Journal of experimental medicine	J Exp Med
Journal of experimental psychology. Learning, memory, and cognition	J Exp Psychol Learn Mem Cogn
Journal of child neurology	J Child Neurol
Journal of neurology, neurosurgery, and psychiatry	J Neurol Neurosurg Psychiatry
Journal of neurophysiology	J Neurophysiol
The Journal of neuroscience : the official journal of the Society for Neuroscience	J Neurosci
Journal of Neuroscience	J Neurosci
Journal of Personality and Social Psychology	J Pers Soc Psychol
Journal of theoretical Biology	J Theor Biol
Law and Contemporary Problems	Law Contemp Probl
Long Range Planning	Long Range Plann
Nature	Nature
Neuropsychologia	Neuropsychologia
Nucleic Acids Research	Nucleic Acids Res
Neuroscience and biobehavioral reviews	Neurosci Biobehav Rev
Neuroscience research	Neurosci Res
Ophthalmology	Ophthalmology
Physiological reviews	Physiol Rev
Organizational Behavior and Human Decision Processes	Organ Behav Hum Decis Process
Proceedings of the National Academy of Sciences of the United States of America	Proc Natl Acad Sci U S A
Progress in neurobiology	Prog Neurobiol
Psychiatry research	Psychiatry Res
Psychological Bulletin	Psychol Bull
Psychological Review	Psychol Rev
Psychological review	Psychol Rev
Psychoneuroendocrinology	Psychoneuroendocrinology
Psychopharmacology	Psychopharmacology (Berl)
Scientific American	Sci Am
Science (New York, N.Y.)	Science
Social Psychology Quarterly	Soc Psychol Q
Transplantation	Transplantation
Trends in neurosciences	Trends Neurosci
Philosophical transactions of the Royal Society of London. Series B, Biological sciences	Philos Trans R Soc Lond B Biol Sci
Journal of evolutionary biology	J Evol Biol
Current biology : CB	Curr Biol
Neural computation	Neural Comput
Consciousness and cognition	Conscious Cogn
Nature Biotechnology	Nat Biotechnol
Journal of Experimental Social Psychology	J Exp Soc Psychol
Journal of Mathematical Psychology	J Math Psychol
Contemporary Educational Psychology	Contemp Educ Psychol
NeuroImage	Neuroimage
Neuroimage	Neuroimage
Developmental psychology	Dev Psychol
Journal of personality disorders	J Pers Disord
Clinical psychology review	Clin Psychol Rev
Experimental and Clinical Psychopharmacology	Exp Clin Psychopharmacol
Journal of Cognitive Neuroscience	J Cogn Neurosci
Journal of cognitive neuroscience	J Cogn Neurosci
Bioinformatics (Oxford, England)	Bioinformatics
Human brain mapping	Hum Brain Mapp
Nature Neuroscience	Nat Neurosci
Nature neuroscience	Nat Neurosci
The American Naturalist	Am Nat
Trends in cognitive sciences	Trends Cogn Sci
The Behavioral and brain sciences	Behav Brain Sci
Behavioural processes	Behav Processes
BMC bioinformatics	BMC Bioinformatics
BMC genomics	BMC Genomics
Genome Biology	Genome Biol
Briefings in bioinformatics	Brief Bioinform
Psychological science : a journal of the American Psychological Society / APS	Psychol Sci
Psychological science	Psychol Sci
Psychological Science	Psychol Sci
BMC Medical Research Methodology	BMC Med Res Methodol
Journal of economic literature	J Econ Lit
Nature reviews. Genetics	Nat Rev Genet
Nature reviews. Neuroscience	Nat Rev Neurosci
EMBO reports	Embo Rep
Health information and libraries journal	Health Info Libr J
CNS Drugs	Cns Drugs
The Neuroscientist : a review journal bringing neurobiology, neurology and psychiatry	Neuroscientist
Journal of Medical Internet Research	J Med Internet Res
The Psychological Record	Psychol Rec
Ieee Network	IEEE Netw
Science	Science
Personality and Individual Differences	Pers Individ Dif
The Quarterly Journal of Economics	Q J Econ
The Journal of Political Economy	J Polit Econ
Social Studies of Science	Soc Stud Sci
Dialogue	Dialogue Can Philos Assoc
Research on Social Work Practice	Res Soc Work Pract
Journal of Business and Psychology	J Bus Psychol
Scientometrics	Scientometrics
Aggressive Behavior	Aggress Behav
Journal of Research in Personality	J Res Pers
Criminal Justice and Behavior	Crim Justice Behav
The chronicle of higher education	Chron High Educ
Analysis	Analysis
Theory and Decision	Theory Decis
Journal of the Medical Library Association : JMLA	J Med Libr Assoc
Journal of Attention Disorders	J Atten Disord
Science Communication	Sci Commun
Management Science	Manage Sci
Cambridge Journal of Economics	Cambridge J Econ
Southern Economic Journal	South Econ J
Intelligence	Intelligence
Annual Review of Sociology	Annu Rev Sociol
European Journal of Social Psychology	Eur J Soc Psychol
Annual Review of Anthropology	Annu Rev Anthropol
The American Statistician	Am Stat
Biostatistics (Oxford, England)	Biostatistics
Journal of Economic Psychology	J Econ Psychol
Government Information Quarterly	Gov Inf Q
Economics Letters	Econ Lett
European Economic Review	Eur Econ Rev
The Review of Economic Studies	Rev Econ Stud
Mathematical Social Sciences	Math Soc Sci
Antipode	Antipode
Journal of Economic Theory	J Econ Theory
IDS Bulletin	Ids Bull
Journal of Risk and Uncertainty	J Risk Uncertain
Journal of Vision	J Vis
Emotion (Washington, D.C.)	Emotion
PLoS Biology	Plos Biol
PLoS biology	Plos Biol
Progress in neurobiology	Prog Neurobiol
BMC Medicine	BMC Med
BMC medicine	BMC Med
Developmental Science	Dev Sci
Developmental science	Dev Sci
IEEE transactions on visualization and computer graphics	IEEE Trans Vis Comput Graph
PLoS medicine	Plos Med
Proceedings. Biological sciences / The Royal Society	Proc Biol Sci
Statistical applications in genetics and molecular biology	Stat Appl Genet Mol Biol
PLoS Computational Biology	Plos Comput Biol
PLoS computational biology	Plos Comput Biol
Molecular systems biology	Mol Syst Biol
Behavior Research Methods	Behav Res Methods
Cognitive neuropsychiatry	Cogn Neuropsychiatry
Games and Economic Behavior	Games Econ Behav
Psychological Inquiry	Psychol Inq
PLoS ONE	Plos One
PloS one	Plos One
Social neuroscience	Soc Neurosci
Neurotherapeutics : the journal of the American Society for Experimental NeuroTherapeutics	Neurotherapeutics
Social cognitive and affective neuroscience	Soc Cogn Affect Neurosci
Cognitive Development	Cogn Dev
BMC research notes	BMC Res Notes
Frontiers in Integrative Neuroscience	Front Integr Neurosci
Frontiers in Computational Neuroscience	Front Comput Neurosci
Frontiers in human neuroscience	Front Hum Neurosci
Frontiers in Neuroscience	Front Neurosci
Nature geoscience	Nat Geosci
Nature Chemistry	Nat Chem
ZooKeys	Zookeys
Judgment and Decision Making	Judgm Decis Mak
Judgment and decision making	Judgm Decis Mak
Frontiers in Ecology and the Environment	Front Ecol Environ
International Economic Review	Int Econ Rev (Philadelphia)
Cognitive Computation	Cognit Comput
Journal of Behavioral Decision Making	J Behav Decis Mak
Political Psychology	Polit Psychol
Science translational medicine	Sci Transl Med
Journal of neuroscience, psychology, and economics	J Neurosci Psychol Econ
Annual Review of Ecology, Evolution, and Systematics	Annu Rev Ecol Evol Syst
Journal of biomedical semantics	J Biomed Semantics


